111111
100001
10P001
100001
100C01
100001
10C001
111111
100C01
100001
10EE01
100001
111111
