111111
100001
10PP01
100001
100C01
100001
10C001
111111
100C01
100001
100E01
100001
111111
