111111
1C0P01
100001
100001
10E001
100J01
111111
