11111111111111111
10000100C01000001
100C010000100P001
10000100001000001
10000100001000001
10000100000000001
100000000000C0001
11100000000000001
10000000001111111
10000100000000001
10E0010000000C001
10000100000000001
11111111111111111