111111
1E0001
10P001
100001
100C01
111111
