111111
100001
10P001
100001
100C01
100001
10C001
100001
100C01
100001
100E01
100001
111111
